sample-id,reads-raw,unique-reads-derep,reads-derep,unique-reads-deblur,reads-deblur,unique-reads-hit-artifact,reads-hit-artifact,unique-reads-chimeric,reads-chimeric,unique-reads-hit-reference,reads-hit-reference,unique-reads-missed-reference,reads-missed-reference
1035,26221,158,630,69,288,0,0,2,3,67,285,0,0
1072,26482,240,1088,86,546,0,0,1,2,85,544,0,0
1133,25774,282,1599,42,695,0,0,0,0,42,695,0,0
1163,28851,259,1278,73,528,0,0,17,48,56,480,0,0
1167,30323,256,1317,69,567,0,0,7,14,62,553,0,0
1244,27919,142,563,61,306,0,0,2,4,59,302,0,0
1314,22271,234,1139,94,522,0,0,4,8,90,514,0,0
1343,22209,238,1183,50,569,0,0,0,0,50,569,0,0
1347,15183,143,750,51,409,0,0,0,0,51,409,0,0
1351,21248,235,1249,61,562,0,0,2,4,59,558,0,0
1365,38177,412,2127,90,892,0,0,9,20,81,872,0,0
1368,34526,373,2189,82,1007,0,0,20,58,62,949,0,0
1380,40466,414,2684,83,1236,0,0,3,6,80,1230,0,0
1386,25345,225,1057,63,480,0,0,10,20,53,460,0,0
1431,39294,330,1592,82,637,0,0,29,63,53,574,0,0
1441,19153,172,799,54,389,0,0,0,0,54,389,0,0
1457,28065,275,1426,58,560,0,0,17,40,41,520,0,0
1466,23072,190,844,50,417,0,0,17,42,33,375,0,0
1488,17347,134,562,74,336,0,0,5,7,69,329,0,0
1493,41486,394,2013,85,842,0,0,50,126,35,716,0,0
1496,34438,274,1319,98,546,0,0,20,40,78,506,0,0
1512,26587,261,1436,45,592,0,0,18,54,27,538,0,0
1552,28673,251,1274,73,599,0,0,30,72,43,527,0,0
1560,33089,185,963,67,377,0,0,2,4,65,373,0,0
1574,33928,274,1403,67,522,0,0,3,5,64,517,0,0
1585,27701,303,1912,40,726,0,0,14,32,26,694,0,0
1607,17833,164,657,69,342,0,0,2,3,67,339,0,0
1608,30953,267,1203,110,624,0,0,18,33,92,591,0,0
1630,21189,164,760,39,302,0,0,3,7,36,295,0,0
1639,44283,495,3010,95,1184,0,0,19,51,76,1133,0,0
1650,56785,610,3457,114,1384,0,0,41,84,73,1300,0,0
1655,36170,350,2058,92,1015,0,0,1,1,91,1014,0,0
1661,34326,311,1530,67,559,0,0,16,32,51,527,0,0
1667,40020,394,2014,56,618,0,0,22,88,34,530,0,0
1730,33931,415,2496,77,949,0,0,15,33,62,916,0,0
1758,41437,746,5516,53,2233,0,0,0,0,53,2233,0,0
1774,40875,482,2843,84,910,0,0,10,18,74,892,0,0
1799,43428,481,2693,85,780,0,0,36,97,49,683,0,0
1806,42558,509,2644,131,1309,0,0,19,41,112,1268,0,0
1818,48779,564,2924,131,1189,0,0,11,22,120,1167,0,0
1822,45004,427,1864,166,939,0,0,18,32,148,907,0,0
1825,43745,495,2747,82,1004,0,0,20,43,62,961,0,0
1864,29504,350,2062,69,874,0,0,24,66,45,808,0,0
1871,46205,571,3464,75,1178,0,0,11,23,64,1155,0,0
1876,22637,163,653,69,328,0,0,0,0,69,328,0,0
1913,34626,314,1535,82,639,0,0,2,3,80,636,0,0
1972,43391,401,2320,59,966,0,0,14,63,45,903,0,0
1973,43756,379,1930,81,746,0,0,16,42,65,704,0,0
2024,77632,948,5480,159,1890,0,0,71,174,88,1716,0,0
2028,50885,683,4731,24,1748,0,0,0,0,24,1748,0,0
2074,30331,248,1214,36,442,0,0,5,11,31,431,0,0
2088,51507,652,4047,75,1599,0,0,0,0,75,1599,0,0
2104,24318,255,1319,57,698,0,0,2,5,55,693,0,0
2108,26128,180,921,76,366,0,0,10,22,66,344,0,0
2118,30001,305,1595,73,736,0,0,20,53,53,683,0,0
2137,19451,162,787,64,394,0,0,6,19,58,375,0,0
3003,42733,445,2321,104,736,0,0,23,50,81,686,0,0
3011,36028,410,1910,125,902,0,0,5,14,120,888,0,0
3012,25582,223,966,64,432,0,0,3,4,61,428,0,0
3021,43898,436,2420,133,1056,0,0,23,50,110,1006,0,0
3022,38288,361,1745,134,828,0,0,15,35,119,793,0,0
3024,52936,542,2870,104,1066,0,0,29,73,75,993,0,0
3031,27930,279,1360,67,621,0,0,0,0,67,621,0,0
3036,18372,112,381,64,224,0,0,2,4,62,220,0,0
3040,23591,182,862,70,499,0,0,9,20,61,479,0,0
3046,28375,285,1416,71,637,0,0,9,21,62,616,0,0
3048,30568,259,1391,42,651,0,0,12,35,30,616,0,0
3049,31868,267,1322,79,549,0,0,20,42,59,507,0,0
3052,24798,213,1214,28,460,0,0,4,9,24,451,0,0
3053,31118,404,2815,20,1101,0,0,1,7,19,1094,0,0
3059,36657,270,1199,99,583,0,0,8,17,91,566,0,0
3060,26549,180,815,61,393,0,0,11,24,50,369,0,0
3063,58042,645,3631,123,1424,0,0,11,20,112,1404,0,0
3068,18894,116,510,42,248,0,0,0,0,42,248,0,0
3073,17994,187,814,83,446,0,0,1,1,82,445,0,0
3080,23128,183,967,56,421,0,0,6,13,50,408,0,0
3086,27620,180,965,66,449,0,0,4,8,62,441,0,0
3087,28746,252,1238,49,455,0,0,11,29,38,426,0,0
3090,26948,260,1173,107,556,0,0,9,18,98,538,0,0
3128,25071,228,1156,46,491,0,0,11,24,35,467,0,0
3162,22780,197,986,48,470,0,0,3,4,45,466,0,0
3173,28480,275,1277,98,539,0,0,21,56,77,483,0,0
3191,28086,383,1926,84,734,0,0,0,0,84,734,0,0
3201,34366,282,1433,81,576,0,0,18,37,63,539,0,0
3213,15870,111,497,36,239,0,0,0,0,36,239,0,0
3217,24591,206,1085,28,478,0,0,2,5,26,473,0,0
3222,20456,142,724,50,352,0,0,1,2,49,350,0,0
8223,16983,165,755,49,347,0,0,0,0,49,347,0,0
8288,23434,221,1065,48,445,0,0,9,18,39,427,0,0
8876,20843,242,1170,53,545,0,0,1,1,52,544,0,0
